20,20,258,1,1314
37,37,260,2,85,618
38,38,260,1,246
40,40,261,1,1510
46,46,261,1,1489
56,56,263,1,1406
57,57,263,2,35,1528
58,58,263,2,459,731
59,59,263,2,324,1731
60,60,263,1,53
61,61,263,10,96,142,420,444,507,680,1126,1589,1635,1834
62,62,263,5,90,310,803,1103,1261
63,63,263,4,130,606,1681,1781
71,71,264,1,981
122,122,271,1,52
187,187,279,1,1482
190,190,279,2,41,1754
191,191,279,1,666
197,197,280,1,472
216,216,283,5,50,68,268,1177,1235
217,217,283,7,199,250,1712,1855,1960,1962,1973
218,218,283,5,617,932,1171,1291,1632
219,219,283,3,304,727,1707
220,220,283,10,7,534,555,623,1090,1129,1287,1565,1817,1967
221,221,283,14,76,174,197,338,451,614,1140,1170,1301,1357,1496,1629,1896,1974
222,222,283,8,178,782,1013,1265,1400,1532,1571,1702
223,223,283,5,234,833,1144,1432,1638
229,229,284,1,1674
231,231,284,1,180
256,256,2,1,1090
256,256,6,1,234
257,257,14,1,451
257,257,15,1,1140
258,258,289,1,1314
260,260,288,1,618
260,260,289,2,85,246
260,260,36,1,197
260,260,39,1,1896
261,261,289,2,1489,1510
263,263,288,7,53,130,606,731,1406,1528,1635
263,263,289,20,35,90,96,142,310,324,420,444,459,507,680,803,1103,1126,1261,1589,1681,1731,1781,1834
264,264,289,1,981
265,265,72,1,1638
265,265,75,2,7,1817
265,265,78,2,50,932
265,265,79,1,623
271,271,289,1,52
274,274,151,1,555
278,278,182,1,199
279,279,290,2,666,1482
279,279,291,2,41,1754
279,279,187,1,1960
279,279,188,2,1144,1265
279,279,190,1,304
280,280,291,1,472
280,280,196,1,1129
282,282,208,1,1712
283,283,290,13,250,451,617,1013,1140,1235,1400,1496,1629,1632,1707,1896,1962
283,283,291,44,7,50,68,76,174,178,197,199,234,268,304,338,534,555,614,623,727,782,833,932,1090,1129,1144,1170,1171,1177,1265,1287,1291,1301,1357,1432,1532,1565,1571,1638,1702,1712,1817,1855,1960,1967,1973,1974
284,284,290,1,1674
284,284,291,1,180
285,285,236,1,1301
287,287,248,6,41,53,310,444,1406,1571
287,287,249,9,35,68,680,727,1013,1103,1754,1834,1974
287,287,250,5,507,534,1291,1314,1589
287,287,251,11,76,85,180,268,338,803,1177,1432,1565,1629,1967
287,287,252,25,90,96,130,250,420,472,606,614,617,618,666,731,833,1170,1357,1400,1482,1510,1532,1632,1635,1674,1702,1731,1962
287,287,253,6,52,324,981,1126,1171,1973
287,287,254,8,142,782,1261,1287,1496,1528,1707,1781
287,287,255,8,174,178,246,459,1235,1489,1681,1855
288,288,292,1,618
288,288,296,3,53,731,1406
288,288,297,1,1635
288,288,299,3,130,606,1528
288,288,257,2,451,1140
288,288,260,1,1896
289,289,300,9,52,310,324,444,680,1103,1261,1510,1681
289,289,301,4,96,981,1126,1489
289,289,302,2,420,507
289,289,303,3,90,246,459
289,289,305,1,35
289,289,306,5,85,142,1314,1589,1731
289,289,307,3,803,1781,1834
289,289,256,2,234,1090
289,289,260,1,197
289,289,265,6,7,50,623,932,1638,1817
290,290,292,1,1896
290,290,293,2,451,1140
290,290,287,21,53,130,250,606,617,618,666,731,1013,1235,1400,1406,1482,1496,1528,1629,1632,1635,1674,1707,1962
291,291,300,1,1817
291,291,302,1,50
291,291,303,2,234,1090
291,291,304,1,623
291,291,306,3,7,932,1638
291,291,307,1,197
291,291,274,1,555
291,291,278,1,199
291,291,279,4,304,1144,1265,1960
291,291,280,1,1129
291,291,282,1,1712
291,291,285,1,1301
291,291,287,57,35,41,52,68,76,85,90,96,142,174,178,180,246,268,310,324,338,420,444,459,472,507,534,614,680,727,782,803,833,981,1103,1126,1170,1171,1177,1261,1287,1291,1314,1357,1432,1489,1510,1532,1565,1571,1589,1681,1702,1731,1754,1781,1834,1855,1967,1973,1974
292,292,288,1,1896
292,292,290,1,618
293,293,288,2,451,1140
296,296,290,3,53,731,1406
297,297,290,1,1635
299,299,290,3,130,606,1528
300,300,289,1,1817
300,300,291,9,52,310,324,444,680,1103,1261,1510,1681
301,301,291,4,96,981,1126,1489
302,302,289,1,50
302,302,291,2,420,507
303,303,289,2,234,1090
303,303,291,3,90,246,459
304,304,289,1,623
305,305,291,1,35
306,306,289,3,7,932,1638
306,306,291,5,85,142,1314,1589,1731
307,307,289,1,197
307,307,291,3,803,1781,1834
