7,7,256,1,233
16,16,258,1,62
32,32,260,2,1173,1975
34,34,260,1,36
37,37,260,1,618
40,40,261,1,1510
45,45,261,1,1290
56,56,263,2,797,1771
57,57,263,1,4
58,58,263,3,513,731,1877
59,59,263,1,1731
60,60,263,2,28,985
61,61,263,5,96,420,1468,1503,1635
62,62,263,3,90,568,1701
63,63,263,4,130,146,606,1803
74,74,265,1,1592
75,75,265,1,1599
77,77,265,1,845
122,122,271,1,1666
124,124,271,1,717
125,125,271,1,1522
137,137,273,1,958
187,187,279,1,1482
191,191,279,1,666
197,197,280,1,472
216,216,283,6,16,75,445,730,1053,1164
217,217,283,8,222,250,484,849,1227,1392,1499,1962
218,218,283,7,617,932,1171,1291,1335,1632,1808
219,219,283,6,1155,1232,1321,1356,1446,1516
220,220,283,3,580,816,1288
221,221,283,8,451,614,1140,1170,1357,1496,1629,1896
222,222,283,4,1,1400,1532,1702
223,223,283,5,25,504,833,1309,1752
229,229,284,1,1674
237,237,285,1,511
240,240,286,1,859
256,256,288,1,233
257,257,10,2,25,1164
257,257,14,1,451
257,257,15,1,1140
258,258,288,1,62
260,260,288,4,36,618,1173,1975
260,260,39,1,1896
261,261,288,1,1290
261,261,289,1,1510
261,261,44,1,1335
263,263,288,14,4,28,130,146,513,568,606,731,797,985,1468,1635,1771,1803
263,263,289,7,90,96,420,1503,1701,1731,1877
265,265,288,3,845,1592,1599
265,265,78,1,932
265,265,79,2,849,1155
271,271,288,3,717,1522,1666
273,273,290,1,958
274,274,144,1,504
276,276,167,1,1227
279,279,290,2,666,1482
279,279,184,1,1232
279,279,186,2,1516,1808
279,279,191,2,222,1309
280,280,291,1,472
282,282,208,1,816
283,283,290,36,1,16,25,75,222,250,451,484,504,580,617,730,816,849,1053,1140,1155,1164,1227,1232,1288,1309,1321,1335,1356,1392,1400,1446,1496,1499,1516,1632,1752,1808,1896,1962
283,283,291,11,445,614,833,932,1170,1171,1291,1357,1532,1629,1702
284,284,290,1,1674
285,285,290,1,511
286,286,290,1,859
287,287,248,12,28,75,233,730,797,845,958,1392,1499,1522,1592,1701
287,287,249,6,1,445,511,580,859,1752
287,287,250,7,36,717,1173,1290,1291,1599,1975
287,287,251,5,146,484,1321,1446,1629
287,287,252,25,90,96,130,250,420,472,606,614,617,618,666,731,833,1170,1357,1400,1482,1510,1532,1632,1635,1674,1702,1731,1962
287,287,253,4,62,985,1171,1803
287,287,254,6,4,16,513,1356,1496,1503
287,287,255,7,568,1053,1288,1468,1666,1771,1877
288,288,292,6,618,1173,1468,1522,1599,1975
288,288,293,1,1771
288,288,294,4,62,985,1290,1803
288,288,295,2,36,845
288,288,296,4,28,513,731,797
288,288,297,3,146,1635,1666
288,288,298,1,233
288,288,299,6,4,130,568,606,717,1592
288,288,257,4,25,451,1140,1164
288,288,260,1,1896
288,288,261,1,1335
288,288,265,2,849,1155
289,289,300,2,1510,1701
289,289,301,1,96
289,289,302,1,420
289,289,303,2,90,1877
289,289,306,2,1503,1731
289,289,265,1,932
290,290,292,1,1896
290,290,293,3,451,849,1140
290,290,294,1,25
290,290,296,1,1164
290,290,299,2,1155,1335
290,290,274,1,504
290,290,276,1,1227
290,290,279,5,222,1232,1309,1516,1808
290,290,282,1,816
290,290,287,53,1,4,16,28,36,62,75,130,146,233,250,484,511,513,568,580,606,617,618,666,717,730,731,797,845,859,958,985,1053,1173,1288,1290,1321,1356,1392,1400,1446,1468,1482,1496,1499,1522,1592,1599,1632,1635,1666,1674,1752,1771,1803,1962,1975
291,291,306,1,932
291,291,287,19,90,96,420,445,472,614,833,1170,1171,1291,1357,1503,1510,1532,1629,1701,1702,1731,1877
292,292,288,1,1896
292,292,290,6,618,1173,1468,1522,1599,1975
293,293,288,3,451,849,1140
293,293,290,1,1771
294,294,288,1,25
294,294,290,4,62,985,1290,1803
295,295,290,2,36,845
296,296,288,1,1164
296,296,290,4,28,513,731,797
297,297,290,3,146,1635,1666
298,298,290,1,233
299,299,288,2,1155,1335
299,299,290,6,4,130,568,606,717,1592
300,300,291,2,1510,1701
301,301,291,1,96
302,302,291,1,420
303,303,291,2,90,1877
306,306,289,1,932
306,306,291,2,1503,1731
