0,0,256,1,1919
2,2,256,1,1724
12,12,257,1,593
13,13,257,1,1755
37,37,260,1,323
73,73,265,1,1442
74,74,265,1,944
76,76,265,1,1212
77,77,265,1,46
79,79,265,1,578
127,127,271,1,1131
143,143,273,1,654
150,150,274,1,547
151,151,274,1,1539
177,177,278,1,300
184,184,279,2,147,1722
185,185,279,1,1192
186,186,279,1,925
187,187,279,1,1062
190,190,279,1,1115
191,191,279,1,1851
193,193,280,1,1012
198,198,280,1,371
213,213,282,1,1554
233,233,285,1,1867
248,248,287,6,241,455,586,920,1354,1869
249,249,287,7,648,818,1018,1162,1675,1704,1937
250,250,287,14,93,261,473,746,750,821,1021,1109,1142,1307,1336,1566,1821,1906
251,251,287,4,1005,1008,1648,1972
252,252,287,13,191,318,373,423,622,748,979,1026,1274,1345,1477,1628,1902
253,253,287,8,82,265,385,1066,1339,1530,1749,1875
254,254,287,10,202,221,294,467,492,505,610,772,1057,1657
255,255,287,10,155,293,314,531,608,960,1373,1555,1684,1703
256,256,289,2,1724,1919
256,256,0,1,1648
257,257,288,1,1755
257,257,289,1,593
260,260,289,1,323
260,260,32,1,293
260,260,34,1,1566
260,260,35,1,610
261,261,41,2,1373,1906
261,261,45,1,467
261,261,46,1,1021
261,261,47,1,1008
263,263,56,6,748,750,821,920,1066,1307
263,263,57,6,155,261,1109,1339,1530,1684
263,263,58,4,82,93,1018,1875
263,263,59,3,648,818,1142
263,263,60,5,221,294,385,1703,1902
263,263,61,1,202
263,263,62,3,314,455,1937
263,263,63,1,191
264,264,66,1,1675
264,264,70,1,531
264,264,71,1,1477
265,265,288,1,578
265,265,289,4,46,944,1212,1442
271,271,289,1,1131
271,271,126,1,492
273,273,291,1,654
274,274,291,2,547,1539
274,274,147,1,1704
276,276,166,1,1869
278,278,291,1,300
279,279,290,1,1722
279,279,291,6,147,925,1062,1115,1192,1851
279,279,185,1,1657
279,279,186,1,1336
279,279,188,1,1274
280,280,290,2,371,1012
280,280,197,1,241
282,282,291,1,1554
283,283,216,5,300,1005,1354,1554,1919
283,283,217,10,147,423,593,608,1057,1062,1131,1162,1749,1867
283,283,218,6,473,547,772,1026,1115,1539
283,283,219,7,46,265,323,925,1192,1212,1972
283,283,220,4,586,979,1442,1724
283,283,221,10,371,373,578,746,1012,1345,1555,1722,1755,1851
283,283,222,3,622,654,1628
283,283,223,4,505,944,960,1821
284,284,226,1,318
285,285,291,1,1867
287,287,290,6,423,920,979,1109,1142,1274
287,287,291,66,82,93,155,191,202,221,241,261,265,293,294,314,318,373,385,455,467,473,492,505,531,586,608,610,622,648,746,748,750,772,818,821,960,1005,1008,1018,1021,1026,1057,1066,1162,1307,1336,1339,1345,1354,1373,1477,1530,1555,1566,1628,1648,1657,1675,1684,1703,1704,1749,1821,1869,1875,1902,1906,1937,1972
288,288,292,1,578
288,288,296,1,1755
288,288,263,3,920,1109,1142
289,289,301,2,46,1442
289,289,302,1,1212
289,289,303,4,593,944,1131,1724
289,289,304,1,323
289,289,305,1,1919
289,289,256,1,1648
289,289,260,3,293,610,1566
289,289,261,5,467,1008,1021,1373,1906
289,289,263,26,82,93,155,191,202,221,261,294,314,385,455,648,748,750,818,821,1018,1066,1307,1339,1530,1684,1703,1875,1902,1937
289,289,264,3,531,1477,1675
289,289,271,1,492
290,290,293,1,920
290,290,294,1,1142
290,290,299,1,1109
290,290,279,1,1274
290,290,283,7,371,423,578,979,1012,1722,1755
291,291,300,3,93,492,1902
291,291,301,6,455,748,1373,1566,1875,1906
291,291,302,9,191,221,294,610,1307,1339,1477,1530,1703
291,291,303,6,531,648,750,821,1008,1675
291,291,304,3,155,1018,1684
291,291,305,4,261,314,1066,1937
291,291,306,4,82,202,467,1648
291,291,307,4,293,385,818,1021
291,291,274,1,1704
291,291,276,1,1869
291,291,279,2,1336,1657
291,291,280,1,241
291,291,283,42,46,147,265,300,323,373,473,505,547,586,593,608,622,654,746,772,925,944,960,1005,1026,1057,1062,1115,1131,1162,1192,1212,1345,1354,1442,1539,1554,1555,1628,1724,1749,1821,1851,1867,1919,1972
291,291,284,1,318
292,292,290,1,578
293,293,288,1,920
294,294,288,1,1142
296,296,290,1,1755
299,299,288,1,1109
300,300,289,3,93,492,1902
301,301,289,6,455,748,1373,1566,1875,1906
301,301,291,2,46,1442
302,302,289,9,191,221,294,610,1307,1339,1477,1530,1703
302,302,291,1,1212
303,303,289,6,531,648,750,821,1008,1675
303,303,291,4,593,944,1131,1724
304,304,289,3,155,1018,1684
304,304,291,1,323
305,305,289,4,261,314,1066,1937
305,305,291,1,1919
306,306,289,4,82,202,467,1648
307,307,289,4,293,385,818,1021
