8,8,257,1,1150
12,12,257,1,1415
15,15,257,1,645
36,36,260,1,1819
37,37,260,3,121,393,872
38,38,260,1,1829
39,39,260,2,1069,1430
40,40,261,1,810
44,44,261,1,532
45,45,261,1,1097
66,66,264,1,1744
79,79,265,1,999
122,122,271,1,1804
126,126,271,2,1194,1531
136,136,273,2,988,1207
139,139,273,1,1912
141,141,273,1,382
143,143,273,1,1281
144,144,274,1,918
145,145,274,3,104,379,597
147,147,274,2,591,1810
149,149,274,2,1456,1990
151,151,274,4,734,1231,1276,1512
152,152,275,6,65,386,589,986,1127,1178
153,153,275,2,1211,1374
154,154,275,2,273,1074
155,155,275,1,1735
156,156,275,3,488,1548,1568
157,157,275,4,419,921,1605,1856
159,159,275,1,1368
161,161,276,2,562,1726
163,163,276,1,21
166,166,276,2,136,962
167,167,276,1,474
169,169,277,1,653
171,171,277,1,453
172,172,277,1,1520
175,175,277,1,1225
184,184,279,2,61,1511
187,187,279,4,401,800,1091,1243
188,188,279,5,186,813,1350,1721,1833
189,189,279,2,1407,1470
190,190,279,3,157,1809,1846
191,191,279,3,497,716,1401
192,192,280,1,871
193,193,280,1,674
195,195,280,1,900
196,196,280,1,1799
197,197,280,2,403,1636
198,198,280,4,667,677,956,1988
199,199,280,2,669,1796
208,208,282,1,1711
210,210,282,3,131,1579,1968
211,211,282,4,125,1198,1277,1506
213,213,282,1,1529
218,218,283,1,932
220,220,283,1,7
223,223,283,2,25,1638
224,224,284,3,1371,1775,1840
225,225,284,1,540
227,227,284,1,218
228,228,284,2,545,763
230,230,284,1,491
231,231,284,2,560,1122
233,233,285,2,790,878
234,234,285,1,416
235,235,285,4,227,400,732,1160
236,236,285,1,1504
237,237,285,4,281,430,529,1852
238,238,285,1,38
239,239,285,1,1220
240,240,286,2,697,1696
241,241,286,4,546,822,1031,1037
242,242,286,1,581
243,243,286,2,598,634
244,244,286,1,1920
245,245,286,1,1882
247,247,286,1,299
248,248,287,10,241,455,586,824,920,998,1216,1354,1410,1869
249,249,287,14,77,167,313,479,648,818,856,992,1018,1162,1444,1675,1704,1937
250,250,287,17,93,261,330,387,473,746,750,821,1021,1109,1142,1175,1307,1336,1566,1821,1906
251,251,287,8,576,719,1005,1008,1141,1648,1903,1972
252,252,287,13,191,318,373,423,622,748,979,1026,1274,1345,1477,1628,1902
253,253,287,18,82,204,265,282,322,385,561,1066,1209,1269,1278,1339,1530,1533,1581,1749,1875,1958
254,254,287,17,202,221,294,394,467,492,505,610,611,752,772,991,1057,1484,1657,1764,1928
255,255,287,14,113,155,293,314,376,531,608,834,960,1373,1555,1684,1703,1772
256,256,0,1,1648
256,256,2,4,732,1278,1371,1374
256,256,4,4,104,918,1368,1579
256,256,5,1,1211
256,256,7,2,878,1735
257,257,289,3,645,1150,1415
257,257,8,2,822,988
257,257,9,1,1529
257,257,10,2,25,1990
257,257,12,2,1840,1988
257,257,15,2,546,962
258,258,16,1,1207
258,258,18,1,1775
258,258,19,1,1809
258,258,20,1,491
258,258,21,2,598,1726
258,258,23,1,38
260,260,288,2,1819,1829
260,260,289,5,121,393,872,1069,1430
260,260,32,2,293,1920
260,260,33,3,218,697,1548
260,260,34,2,1277,1566
260,260,35,2,136,610
260,260,36,2,653,1856
260,260,37,1,1796
260,260,38,2,167,419
260,260,39,2,299,400
261,261,288,3,532,810,1097
261,261,40,3,125,1178,1568
261,261,41,2,1373,1906
261,261,44,1,1912
261,261,45,2,227,467
261,261,46,1,1021
261,261,47,4,1008,1276,1711,1799
262,262,49,2,677,1456
262,262,50,2,497,1037
262,262,51,1,560
262,262,54,2,1696,1882
262,262,55,4,591,763,1031,1852
263,263,56,13,65,529,669,748,750,821,824,871,920,1066,1307,1764,1819
263,263,57,13,155,261,330,992,998,1109,1127,1160,1339,1530,1684,1829,1833
263,263,58,13,82,93,121,581,810,1018,1150,1220,1231,1470,1744,1846,1875
263,263,59,14,61,387,401,403,430,540,648,734,818,1142,1175,1269,1504,1506
263,263,60,12,221,294,385,562,674,856,872,1209,1511,1581,1703,1902
263,263,61,12,202,379,393,394,645,790,991,999,1097,1415,1484,1533
263,263,62,12,281,314,376,455,474,532,1069,1430,1636,1772,1937,1968
263,263,63,9,191,322,634,1091,1194,1243,1350,1531,1804
264,264,288,1,1744
264,264,64,1,21
264,264,66,2,1198,1675
264,264,67,1,273
264,264,68,2,157,453
264,264,69,2,576,1074
264,264,70,3,386,531,921
264,264,71,2,1477,1810
265,265,288,1,999
265,265,72,4,186,813,1520,1638
265,265,73,1,1401
265,265,74,3,545,800,1721
265,265,75,3,7,597,1407
265,265,76,1,1605
265,265,78,2,932,1281
265,265,79,1,956
266,266,85,1,1512
271,271,288,3,1194,1531,1804
271,271,120,1,716
271,271,121,1,382
271,271,122,2,900,1122
271,271,123,1,986
271,271,124,2,589,1958
271,271,125,2,131,416
271,271,126,4,488,492,667,1225
273,273,290,2,382,988
273,273,291,3,1207,1281,1912
274,274,290,5,379,597,918,1456,1512
274,274,291,7,104,591,734,1231,1276,1810,1990
274,274,147,2,834,1704
274,274,149,1,1903
275,275,290,13,273,386,419,589,921,986,1074,1211,1368,1374,1548,1568,1605
275,275,291,6,65,488,1127,1178,1735,1856
276,276,290,4,21,136,962,1726
276,276,291,2,474,562
276,276,166,1,1869
277,277,290,3,453,653,1520
277,277,291,1,1225
278,278,181,1,479
279,279,290,10,157,186,497,716,813,1470,1511,1721,1809,1846
279,279,291,9,61,401,800,1091,1243,1350,1401,1407,1833
279,279,185,1,1657
279,279,186,1,1336
279,279,188,1,1274
280,280,290,6,667,677,900,956,1796,1988
280,280,291,6,403,669,674,871,1636,1799
280,280,197,1,241
282,282,290,6,125,1198,1277,1529,1579,1968
282,282,291,3,131,1506,1711
283,283,290,1,25
283,283,291,3,7,932,1638
283,283,216,4,204,1005,1354,1444
283,283,217,5,423,608,1057,1162,1749
283,283,218,6,77,473,719,772,1026,1141
283,283,219,5,265,313,752,1410,1972
283,283,220,3,586,979,1928
283,283,221,4,373,746,1345,1555
283,283,222,3,113,622,1628
283,283,223,4,282,505,960,1821
284,284,290,8,491,540,545,560,763,1122,1371,1775
284,284,291,2,218,1840
284,284,225,1,561
284,284,226,1,318
284,284,227,1,611
285,285,290,7,227,400,416,790,1160,1220,1504
285,285,291,7,38,281,430,529,732,878,1852
286,286,290,9,299,598,634,697,822,1037,1696,1882,1920
286,286,291,3,546,581,1031
286,286,247,1,1216
287,287,290,42,77,113,167,204,282,313,322,330,376,387,394,423,479,561,576,611,719,752,824,834,856,979,991,992,998,1141,1175,1209,1216,1269,1274,1278,1410,1444,1484,1533,1581,1764,1772,1903,1928,1958
287,287,291,69,82,93,155,191,202,221,241,261,265,293,294,314,318,373,385,455,467,473,492,505,531,586,608,610,622,648,746,748,750,772,818,821,920,960,1005,1008,1018,1021,1026,1057,1066,1109,1142,1162,1307,1336,1339,1345,1354,1373,1477,1530,1555,1566,1628,1648,1657,1675,1684,1703,1704,1749,1821,1869,1875,1902,1906,1937,1972
288,288,256,7,918,1211,1278,1368,1371,1374,1579
288,288,257,6,25,822,962,988,1529,1988
288,288,258,5,491,598,1726,1775,1809
288,288,260,11,136,167,299,400,419,653,697,1277,1548,1796,1920
288,288,261,3,125,227,1568
288,288,262,8,497,560,677,763,1037,1456,1696,1882
288,288,263,39,322,330,376,379,387,394,532,540,634,790,810,824,856,991,992,998,999,1097,1160,1175,1194,1209,1220,1269,1470,1484,1504,1511,1531,1533,1581,1744,1764,1772,1804,1819,1829,1846,1968
288,288,264,9,21,157,273,386,453,576,921,1074,1198
288,288,265,8,186,545,597,813,956,1520,1605,1721
288,288,266,1,1512
288,288,271,9,382,416,589,667,716,900,986,1122,1958
289,289,256,5,104,732,878,1648,1735
289,289,257,3,546,1840,1990
289,289,258,2,38,1207
289,289,260,5,218,293,610,1566,1856
289,289,261,10,467,1008,1021,1178,1276,1373,1711,1799,1906,1912
289,289,262,3,591,1031,1852
289,289,263,59,61,65,82,93,121,155,191,202,221,261,281,294,314,385,393,401,403,430,455,474,529,562,581,645,648,669,674,734,748,750,818,821,871,872,920,1018,1066,1069,1091,1109,1127,1142,1150,1231,1243,1307,1339,1350,1415,1430,1506,1530,1636,1684,1703,1833,1875,1902,1937
289,289,264,4,531,1477,1675,1810
289,289,265,7,7,800,932,1281,1401,1407,1638
289,289,271,4,131,488,492,1225
290,290,292,3,322,379,1605
290,290,293,2,824,998
290,290,294,32,21,25,136,186,227,273,386,387,394,419,453,497,545,560,598,697,716,918,962,988,1122,1198,1209,1211,1277,1368,1371,1520,1696,1726,1796,1882
290,290,295,5,1278,1581,1772,1846,1958
290,290,296,5,376,856,1160,1470,1764
290,290,297,7,167,576,634,790,992,1175,1529
290,290,298,36,125,157,299,382,400,416,491,589,597,653,667,677,763,813,822,900,921,956,986,991,1037,1074,1269,1374,1456,1484,1512,1548,1568,1579,1721,1775,1809,1920,1968,1988
290,290,299,6,330,540,1220,1504,1511,1533
290,290,274,2,834,1903
290,290,278,1,479
290,290,279,1,1274
290,290,283,13,77,113,204,282,313,423,719,752,979,1141,1410,1444,1928
290,290,284,2,561,611
290,290,286,1,1216
291,291,300,7,65,93,492,529,674,1350,1902
291,291,301,10,281,401,455,748,1231,1373,1506,1566,1875,1906
291,291,302,12,61,191,221,294,403,610,920,1307,1339,1477,1530,1703
291,291,303,9,531,648,750,821,1008,1091,1127,1675,1852
291,291,304,7,155,562,871,1018,1109,1225,1684
291,291,305,7,261,314,669,1066,1142,1833,1937
291,291,306,35,7,38,82,104,131,202,218,430,467,488,546,591,732,734,800,878,932,1031,1178,1207,1243,1276,1281,1401,1407,1638,1648,1711,1735,1799,1810,1840,1856,1912,1990
291,291,307,7,293,385,474,581,818,1021,1636
291,291,274,1,1704
291,291,276,1,1869
291,291,279,2,1336,1657
291,291,280,1,241
291,291,283,21,265,373,473,505,586,608,622,746,772,960,1005,1026,1057,1162,1345,1354,1555,1628,1749,1821,1972
291,291,284,1,318
292,292,288,3,322,379,1605
293,293,288,2,824,998
294,294,288,32,21,25,136,186,227,273,386,387,394,419,453,497,545,560,598,697,716,918,962,988,1122,1198,1209,1211,1277,1368,1371,1520,1696,1726,1796,1882
295,295,288,5,1278,1581,1772,1846,1958
296,296,288,5,376,856,1160,1470,1764
297,297,288,7,167,576,634,790,992,1175,1529
298,298,288,36,125,157,299,382,400,416,491,589,597,653,667,677,763,813,822,900,921,956,986,991,1037,1074,1269,1374,1456,1484,1512,1548,1568,1579,1721,1775,1809,1920,1968,1988
299,299,288,6,330,540,1220,1504,1511,1533
300,300,289,7,65,93,492,529,674,1350,1902
301,301,289,10,281,401,455,748,1231,1373,1506,1566,1875,1906
302,302,289,12,61,191,221,294,403,610,920,1307,1339,1477,1530,1703
303,303,289,9,531,648,750,821,1008,1091,1127,1675,1852
304,304,289,7,155,562,871,1018,1109,1225,1684
305,305,289,7,261,314,669,1066,1142,1833,1937
306,306,289,35,7,38,82,104,131,202,218,430,467,488,546,591,732,734,800,878,932,1031,1178,1207,1243,1276,1281,1401,1407,1638,1648,1711,1735,1799,1810,1840,1856,1912,1990
307,307,289,7,293,385,474,581,818,1021,1636
