2,2,256,1,874
7,7,256,1,233
14,14,257,1,1714
16,16,258,1,62
17,17,258,1,292
19,19,258,2,1594,1915
20,20,258,1,111
21,21,258,1,1918
23,23,258,1,440
32,32,260,5,840,1173,1613,1791,1975
33,33,260,1,1740
34,34,260,2,36,1534
35,35,260,2,570,1381
36,36,260,1,1168
37,37,260,1,618
38,38,260,2,1299,1622
40,40,261,1,1510
44,44,261,1,1859
45,45,261,1,1290
47,47,261,1,1899
50,50,262,1,883
51,51,262,1,1185
56,56,263,5,690,780,797,1252,1771
57,57,263,2,4,469
58,58,263,6,122,513,731,961,1205,1877
59,59,263,4,1310,1434,1731,1841
60,60,263,5,28,413,985,1661,1762
61,61,263,11,96,420,660,673,760,1146,1327,1468,1503,1635,1909
62,62,263,11,8,90,109,568,795,1084,1298,1441,1701,1719,1788
63,63,263,12,63,130,146,566,606,723,1117,1285,1681,1781,1793,1803
71,71,264,1,1933
74,74,265,1,1592
75,75,265,2,1599,1610
77,77,265,1,845
121,121,271,1,1138
122,122,271,3,863,1228,1666
124,124,271,1,717
125,125,271,1,1522
137,137,273,1,958
187,187,279,1,1482
191,191,279,1,666
197,197,280,1,472
216,216,283,5,16,75,445,730,1053
217,217,283,5,250,484,1392,1499,1962
218,218,283,2,617,1632
219,219,283,3,1321,1356,1446
220,220,283,2,580,1288
221,221,283,5,614,1170,1357,1496,1629
222,222,283,4,1,1400,1532,1702
223,223,283,2,833,1752
229,229,284,1,1674
237,237,285,1,511
240,240,286,1,859
256,256,288,2,233,874
257,257,288,1,1714
257,257,9,1,690
257,257,12,1,660
258,258,288,7,62,111,292,440,1594,1915,1918
260,260,288,14,36,570,618,840,1168,1173,1299,1381,1534,1613,1622,1740,1791,1975
261,261,288,3,1290,1859,1899
261,261,289,1,1510
261,261,46,1,780
262,262,288,2,883,1185
263,263,288,44,4,8,28,109,122,130,146,413,469,513,566,568,606,660,673,690,723,731,760,780,795,797,961,985,1084,1146,1205,1252,1285,1298,1310,1327,1434,1441,1468,1635,1661,1719,1762,1771,1788,1803,1841,1909
263,263,289,12,63,90,96,420,1117,1503,1681,1701,1731,1781,1793,1877
264,264,288,1,1933
264,264,65,1,413
265,265,288,4,845,1592,1599,1610
265,265,73,1,1661
265,265,74,2,1084,1719
265,265,75,2,673,1788
265,265,76,2,63,1285
265,265,78,1,8
271,271,288,6,717,863,1138,1228,1522,1666
273,273,290,1,958
273,273,137,1,961
273,273,139,1,1899
273,273,140,2,1610,1793
273,273,142,1,1138
274,274,145,5,883,1381,1613,1841,1915
274,274,146,2,1205,1434
274,274,150,1,1918
275,275,159,1,723
276,276,161,1,1228
276,276,164,1,1933
276,276,167,1,440
278,278,180,1,1310
279,279,290,2,666,1482
279,279,184,3,109,795,1622
279,279,187,2,570,1117
279,279,188,2,760,1791
279,279,190,3,1252,1534,1714
279,279,191,3,566,840,1909
280,280,291,1,472
280,280,193,2,469,1168
280,280,198,1,1740
280,280,199,1,1299
282,282,215,1,874
283,283,290,20,1,16,75,250,484,580,617,730,1053,1288,1321,1356,1392,1400,1446,1496,1499,1632,1752,1962
283,283,291,8,445,614,833,1170,1357,1532,1629,1702
284,284,290,1,1674
284,284,226,2,1146,1594
285,285,290,1,511
285,285,232,1,1441
285,285,233,4,111,122,863,1762
285,285,234,1,1327
285,285,235,1,292
285,285,236,1,1859
285,285,237,1,1185
285,285,239,1,1298
286,286,290,1,859
287,287,248,12,28,75,233,730,797,845,958,1392,1499,1522,1592,1701
287,287,249,6,1,445,511,580,859,1752
287,287,250,6,36,717,1173,1290,1599,1975
287,287,251,5,146,484,1321,1446,1629
287,287,252,25,90,96,130,250,420,472,606,614,617,618,666,731,833,1170,1357,1400,1482,1510,1532,1632,1635,1674,1702,1731,1962
287,287,253,3,62,985,1803
287,287,254,7,4,16,513,1356,1496,1503,1781
287,287,255,8,568,1053,1288,1468,1666,1681,1771,1877
288,288,292,8,469,618,1173,1468,1522,1599,1841,1975
288,288,293,2,1714,1771
288,288,294,5,62,985,1290,1762,1803
288,288,295,9,36,122,723,845,961,1252,1298,1327,1791
288,288,296,5,28,513,566,731,797
288,288,297,5,146,1310,1534,1635,1666
288,288,298,4,233,760,795,1434
288,288,299,35,4,109,111,130,292,440,568,570,606,717,840,863,874,883,1138,1146,1168,1185,1205,1228,1299,1381,1441,1592,1594,1610,1613,1622,1740,1859,1899,1909,1915,1918,1933
288,288,257,2,660,690
288,288,261,1,780
288,288,264,1,413
288,288,265,7,8,673,1084,1285,1661,1719,1788
289,289,300,4,1117,1510,1681,1701
289,289,301,1,96
289,289,302,1,420
289,289,303,3,90,1793,1877
289,289,306,2,1503,1731
289,289,307,1,1781
289,289,265,1,63
290,290,273,4,961,1138,1610,1899
290,290,274,8,883,1205,1381,1434,1613,1841,1915,1918
290,290,275,1,723
290,290,276,3,440,1228,1933
290,290,278,1,1310
290,290,279,12,109,566,570,760,795,840,1252,1534,1622,1714,1791,1909
290,290,280,4,469,1168,1299,1740
290,290,282,1,874
290,290,284,2,1146,1594
290,290,285,10,111,122,292,863,1185,1298,1327,1441,1762,1859
290,290,287,53,1,4,16,28,36,62,75,130,146,233,250,484,511,513,568,580,606,617,618,666,717,730,731,797,845,859,958,985,1053,1173,1288,1290,1321,1356,1392,1400,1446,1468,1482,1496,1499,1522,1592,1599,1632,1635,1666,1674,1752,1771,1803,1962,1975
291,291,273,1,1793
291,291,279,1,1117
291,291,287,19,90,96,420,445,472,614,833,1170,1357,1503,1510,1532,1629,1681,1701,1702,1731,1781,1877
292,292,290,8,469,618,1173,1468,1522,1599,1841,1975
293,293,290,2,1714,1771
294,294,290,5,62,985,1290,1762,1803
295,295,290,9,36,122,723,845,961,1252,1298,1327,1791
296,296,290,5,28,513,566,731,797
297,297,290,5,146,1310,1534,1635,1666
298,298,290,4,233,760,795,1434
299,299,290,35,4,109,111,130,292,440,568,570,606,717,840,863,874,883,1138,1146,1168,1185,1205,1228,1299,1381,1441,1592,1594,1610,1613,1622,1740,1859,1899,1909,1915,1918,1933
300,300,291,4,1117,1510,1681,1701
301,301,291,1,96
302,302,291,1,420
303,303,291,3,90,1793,1877
306,306,291,2,1503,1731
307,307,291,1,1781
