1,1,256,1,1443
5,5,256,1,1157
8,8,257,1,1323
13,13,257,1,909
14,14,257,1,384
15,15,257,1,255
16,16,258,1,893
49,49,262,2,74,1763
50,50,262,1,891
52,52,262,1,1738
54,54,262,2,163,955
59,59,263,2,1226,1676
60,60,263,2,212,1302
62,62,263,1,1193
65,65,264,1,784
67,67,264,1,774
69,69,264,2,433,1952
71,71,264,1,672
72,72,265,1,1891
120,120,271,1,343
121,121,271,1,252
122,122,271,3,828,850,1742
124,124,271,1,95
126,126,271,1,114
141,141,273,1,1541
144,144,274,1,346
151,151,274,1,1023
152,152,275,4,60,65,679,843
154,154,275,1,395
155,155,275,1,411
156,156,275,1,1548
157,157,275,1,1856
158,158,275,1,1831
160,160,276,1,997
161,161,276,1,103
162,162,276,1,1535
167,167,276,1,1423
169,169,277,2,306,967
171,171,277,1,305
175,175,277,1,954
184,184,279,13,47,61,147,198,325,657,777,1206,1365,1437,1575,1884,1942
185,185,279,6,349,701,765,1192,1248,1604
186,186,279,5,172,925,1059,1080,1294
187,187,279,7,190,401,800,1062,1091,1243,1397
188,188,279,9,509,896,1045,1350,1601,1670,1826,1833,1894
189,189,279,8,200,1068,1139,1322,1396,1407,1464,1970
190,190,279,5,9,41,572,1115,1754
191,191,279,20,275,316,345,365,497,666,710,716,996,1007,1032,1186,1244,1313,1349,1401,1728,1790,1851,1984
192,192,280,1,1229
193,193,280,1,674
194,194,280,1,1813
197,197,280,1,1487
199,199,280,1,355
211,211,282,2,1798,1800
212,212,282,1,1717
213,213,282,1,1070
220,220,283,1,1817
221,221,283,1,197
224,224,284,3,239,461,1275
225,225,284,1,98
226,226,284,1,768
227,227,284,1,218
230,230,284,1,636
233,233,285,2,1361,1436
234,234,285,2,87,380
235,235,285,1,240
236,236,285,2,226,229
237,237,285,1,529
238,238,285,1,493
239,239,285,1,1300
240,240,286,2,697,1618
241,241,286,1,1995
246,246,286,1,1569
247,247,286,1,825
250,250,287,2,93,1566
252,252,287,1,1902
254,254,287,2,492,610
255,255,287,1,293
256,256,289,2,1157,1443
256,256,2,1,1436
256,256,4,1,411
256,256,5,1,345
256,256,6,1,1322
256,256,7,2,380,1139
257,257,288,1,909
257,257,289,3,255,384,1323
257,257,10,1,1437
257,257,14,1,1790
258,258,289,1,893
258,258,17,1,240
258,258,18,1,1970
258,258,19,2,1300,1670
258,258,21,1,1826
258,258,23,1,1275
260,260,32,10,293,305,343,768,891,1059,1423,1717,1738,1891
260,260,33,25,9,60,74,98,198,218,346,365,433,636,672,697,828,909,955,997,1007,1070,1206,1229,1349,1443,1535,1548,1831
260,260,34,7,95,893,1541,1566,1575,1676,1995
260,260,35,6,103,212,355,610,850,1186
260,260,36,10,163,197,384,509,784,1487,1569,1742,1798,1856
260,260,37,12,229,255,395,493,774,825,1080,1157,1313,1618,1763,1952
260,260,38,8,252,306,461,896,954,1193,1302,1813
260,260,39,6,114,765,967,1226,1323,1728
261,261,42,1,843
261,261,45,1,1361
262,262,288,2,74,1763
262,262,289,4,163,891,955,1738
262,262,50,1,497
262,262,53,1,239
263,263,289,5,212,1193,1226,1302,1676
263,263,56,2,65,529
263,263,57,1,1833
263,263,58,1,93
263,263,59,2,61,401
263,263,60,2,674,1902
263,263,63,3,1091,1243,1350
264,264,289,5,433,672,774,784,1952
264,264,66,1,1294
264,264,67,2,87,226
264,264,69,1,679
264,264,71,1,1601
265,265,289,1,1891
265,265,72,2,316,996
265,265,73,1,1401
265,265,74,1,800
265,265,75,2,1407,1817
265,265,77,2,1023,1800
271,271,289,7,95,114,252,343,828,850,1742
271,271,120,1,716
271,271,121,1,1604
271,271,122,1,1397
271,271,124,1,1884
271,271,126,1,492
273,273,291,1,1541
274,274,291,2,346,1023
274,274,149,1,47
274,274,150,1,657
274,274,151,1,1045
275,275,290,2,1548,1831
275,275,291,7,60,65,395,411,679,843,1856
276,276,291,4,103,997,1423,1535
276,276,160,1,1365
276,276,167,2,1464,1894
277,277,291,4,305,306,954,967
277,277,169,1,572
277,277,171,1,1248
277,277,173,1,325
277,277,174,1,777
279,279,290,8,9,316,497,666,716,765,1248,1728
279,279,291,65,41,47,61,147,172,190,198,200,275,325,345,349,365,401,509,572,657,701,710,777,800,896,925,996,1007,1032,1045,1059,1062,1068,1080,1091,1115,1139,1186,1192,1206,1243,1244,1294,1313,1322,1349,1350,1365,1396,1397,1401,1407,1437,1464,1575,1601,1604,1670,1754,1790,1826,1833,1851,1884,1894,1942,1970,1984
280,280,291,5,355,674,1229,1487,1813
280,280,192,1,1942
282,282,290,1,1070
282,282,291,3,1717,1798,1800
282,282,208,1,710
282,282,211,1,275
282,282,214,1,1032
283,283,291,2,197,1817
283,283,217,2,147,1062
283,283,218,1,1115
283,283,219,2,925,1192
283,283,221,1,1851
284,284,291,7,98,218,239,461,636,768,1275
284,284,225,1,1396
285,285,291,10,87,226,229,240,380,493,529,1300,1361,1436
285,285,232,2,172,1984
285,285,233,2,190,200
285,285,239,1,349
286,286,290,1,697
286,286,291,4,825,1569,1618,1995
286,286,241,1,1244
286,286,243,1,1068
286,286,246,1,701
287,287,291,6,93,293,492,610,1566,1902
287,287,248,1,41
287,287,249,1,1754
287,287,252,1,666
288,288,260,10,9,74,697,765,909,1070,1548,1728,1763,1831
288,288,262,1,497
288,288,265,1,316
288,288,271,1,716
289,289,256,6,345,380,411,1139,1322,1436
289,289,257,2,1437,1790
289,289,258,6,240,1275,1300,1670,1826,1970
289,289,260,74,60,95,98,103,114,163,197,198,212,218,229,252,255,293,305,306,343,346,355,365,384,395,433,461,493,509,610,636,672,768,774,784,825,828,850,891,893,896,954,955,967,997,1007,1059,1080,1157,1186,1193,1206,1226,1229,1302,1313,1323,1349,1423,1443,1487,1535,1541,1566,1569,1575,1618,1676,1717,1738,1742,1798,1813,1856,1891,1952,1995
289,289,261,2,843,1361
289,289,262,1,239
289,289,263,11,61,65,93,401,529,674,1091,1243,1350,1833,1902
289,289,264,5,87,226,679,1294,1601
289,289,265,7,800,996,1023,1401,1407,1800,1817
289,289,271,4,492,1397,1604,1884
290,290,292,1,1831
290,290,293,2,1070,1728
290,290,294,3,497,697,716
290,290,295,1,9
290,290,297,2,316,765
290,290,298,1,1548
290,290,277,1,1248
290,290,287,1,666
291,291,300,25,65,93,226,239,240,365,380,411,461,492,529,674,679,843,1007,1023,1275,1300,1350,1361,1423,1436,1618,1800,1902
291,291,301,12,306,401,509,768,825,1206,1229,1566,1601,1717,1798,1826
291,291,302,12,61,87,305,610,636,967,997,1437,1535,1575,1604,1970
291,291,303,9,60,98,345,493,1059,1080,1091,1884,1995
291,291,304,5,355,896,996,1294,1397
291,291,305,9,103,198,954,1139,1313,1322,1487,1670,1833
291,291,306,7,218,800,1243,1401,1407,1817,1856
291,291,307,11,197,229,293,346,395,1186,1349,1541,1569,1790,1813
291,291,274,3,47,657,1045
291,291,276,3,1365,1464,1894
291,291,277,3,325,572,777
291,291,280,1,1942
291,291,282,3,275,710,1032
291,291,283,6,147,925,1062,1115,1192,1851
291,291,284,1,1396
291,291,285,5,172,190,200,349,1984
291,291,286,3,701,1068,1244
291,291,287,2,41,1754
292,292,288,1,1831
293,293,288,2,1070,1728
294,294,288,3,497,697,716
295,295,288,1,9
297,297,288,2,316,765
298,298,288,1,1548
300,300,289,25,65,93,226,239,240,365,380,411,461,492,529,674,679,843,1007,1023,1275,1300,1350,1361,1423,1436,1618,1800,1902
301,301,289,12,306,401,509,768,825,1206,1229,1566,1601,1717,1798,1826
302,302,289,12,61,87,305,610,636,967,997,1437,1535,1575,1604,1970
303,303,289,9,60,98,345,493,1059,1080,1091,1884,1995
304,304,289,5,355,896,996,1294,1397
305,305,289,9,103,198,954,1139,1313,1322,1487,1670,1833
306,306,289,7,218,800,1243,1401,1407,1817,1856
307,307,289,11,197,229,293,346,395,1186,1349,1541,1569,1790,1813
