8,8,257,1,1150
12,12,257,1,1415
15,15,257,1,645
36,36,260,1,1819
37,37,260,3,121,393,872
39,39,260,2,1069,1430
137,137,273,1,1388
138,138,273,1,182
145,145,274,1,1044
151,151,274,2,734,1231
152,152,275,4,60,65,1127,1474
158,158,275,3,919,1508,1625
161,161,276,2,184,562
165,165,276,1,1419
167,167,276,1,474
174,174,277,1,258
184,184,279,2,61,1884
186,186,279,2,1059,1080
187,187,279,3,401,1091,1243
188,188,279,2,1350,1833
191,191,279,1,345
192,192,280,1,871
193,193,280,1,674
197,197,280,2,403,1636
199,199,280,1,669
208,208,282,1,543
211,211,282,1,1506
212,212,282,1,20
220,220,283,1,1090
223,223,283,1,234
224,224,284,1,23
225,225,284,1,98
226,226,284,1,1521
232,232,285,1,1377
234,234,285,1,700
235,235,285,1,1408
236,236,285,1,1181
237,237,285,6,281,430,529,1015,1067,1663
238,238,285,2,493,1956
241,241,286,1,1995
242,242,286,1,581
248,248,287,7,241,455,586,824,920,1354,1869
249,249,287,7,648,818,1018,1162,1675,1704,1937
250,250,287,17,93,261,330,387,473,746,750,821,1021,1109,1142,1175,1307,1336,1566,1821,1906
251,251,287,4,1005,1008,1648,1972
252,252,287,10,191,318,373,622,748,1026,1345,1477,1628,1902
253,253,287,8,82,265,385,1066,1339,1530,1749,1875
254,254,287,11,202,221,294,467,492,505,610,772,1057,1657,1764
255,255,287,10,155,293,314,531,608,960,1373,1555,1684,1703
256,256,0,2,23,1648
256,256,2,1,1090
256,256,5,1,345
256,256,6,2,234,1044
256,256,7,1,1474
257,257,289,3,645,1150,1415
257,257,11,2,182,1181
258,258,19,2,543,1956
258,258,23,1,1521
260,260,288,1,1819
260,260,289,5,121,393,872,1069,1430
260,260,32,2,293,1059
260,260,33,2,60,98
260,260,34,2,1566,1995
260,260,35,1,610
260,260,37,2,493,1080
261,261,40,2,1377,1508
261,261,41,2,1373,1906
261,261,42,1,1625
261,261,45,1,467
261,261,46,1,1021
261,261,47,1,1008
262,262,48,1,1419
262,262,52,2,20,1388
262,262,55,1,1015
263,263,56,13,65,529,669,748,750,821,824,871,920,1066,1307,1764,1819
263,263,57,9,155,261,330,1109,1127,1339,1530,1684,1833
263,263,58,8,82,93,121,581,1018,1150,1231,1875
263,263,59,11,61,387,401,403,430,648,734,818,1142,1175,1506
263,263,60,8,221,294,385,562,674,872,1703,1902
263,263,61,4,202,393,645,1415
263,263,62,8,281,314,455,474,1069,1430,1636,1937
263,263,63,4,191,1091,1243,1350
264,264,66,2,919,1675
264,264,69,1,700
264,264,70,1,531
264,264,71,1,1477
265,265,75,2,184,1067
265,265,77,1,1663
271,271,124,2,258,1884
271,271,126,1,492
271,271,127,1,1408
273,273,291,2,182,1388
274,274,291,3,734,1044,1231
274,274,147,1,1704
275,275,291,7,60,65,919,1127,1474,1508,1625
276,276,291,4,184,474,562,1419
276,276,166,1,1869
277,277,291,1,258
279,279,291,10,61,345,401,1059,1080,1091,1243,1350,1833,1884
279,279,185,1,1657
279,279,186,1,1336
280,280,291,5,403,669,674,871,1636
280,280,197,1,241
282,282,291,3,20,543,1506
283,283,291,2,234,1090
283,283,216,2,1005,1354
283,283,217,4,608,1057,1162,1749
283,283,218,3,473,772,1026
283,283,219,2,265,1972
283,283,220,1,586
283,283,221,4,373,746,1345,1555
283,283,222,2,622,1628
283,283,223,3,505,960,1821
284,284,291,3,23,98,1521
284,284,226,1,318
285,285,291,12,281,430,493,529,700,1015,1067,1181,1377,1408,1663,1956
286,286,291,2,581,1995
287,287,290,5,330,387,824,1175,1764
287,287,291,69,82,93,155,191,202,221,241,261,265,293,294,314,318,373,385,455,467,473,492,505,531,586,608,610,622,648,746,748,750,772,818,821,920,960,1005,1008,1018,1021,1026,1057,1066,1109,1142,1162,1307,1336,1339,1345,1354,1373,1477,1530,1555,1566,1628,1648,1657,1675,1684,1703,1704,1749,1821,1869,1875,1902,1906,1937,1972
288,288,263,6,330,387,824,1175,1764,1819
289,289,256,7,23,234,345,1044,1090,1474,1648
289,289,257,2,182,1181
289,289,258,3,543,1521,1956
289,289,260,9,60,98,293,493,610,1059,1080,1566,1995
289,289,261,8,467,1008,1021,1373,1377,1508,1625,1906
289,289,262,4,20,1015,1388,1419
289,289,263,59,61,65,82,93,121,155,191,202,221,261,281,294,314,385,393,401,403,430,455,474,529,562,581,645,648,669,674,734,748,750,818,821,871,872,920,1018,1066,1069,1091,1109,1127,1142,1150,1231,1243,1307,1339,1350,1415,1430,1506,1530,1636,1684,1703,1833,1875,1902,1937
289,289,264,5,531,700,919,1477,1675
289,289,265,3,184,1067,1663
289,289,271,4,258,492,1408,1884
290,290,293,1,824
290,290,294,1,387
290,290,296,1,1764
290,290,297,1,1175
290,290,299,1,330
291,291,300,7,65,93,492,529,674,1350,1902
291,291,301,10,281,401,455,748,1231,1373,1506,1566,1875,1906
291,291,302,12,61,191,221,294,403,610,920,1307,1339,1477,1530,1703
291,291,303,40,20,23,60,98,182,184,234,258,345,493,531,543,648,700,750,821,919,1008,1015,1044,1059,1067,1080,1090,1091,1127,1181,1377,1388,1408,1419,1474,1508,1521,1625,1663,1675,1884,1956,1995
291,291,304,6,155,562,871,1018,1109,1684
291,291,305,7,261,314,669,1066,1142,1833,1937
291,291,306,7,82,202,430,467,734,1243,1648
291,291,307,7,293,385,474,581,818,1021,1636
291,291,274,1,1704
291,291,276,1,1869
291,291,279,2,1336,1657
291,291,280,1,241
291,291,283,21,265,373,473,505,586,608,622,746,772,960,1005,1026,1057,1162,1345,1354,1555,1628,1749,1821,1972
291,291,284,1,318
293,293,288,1,824
294,294,288,1,387
296,296,288,1,1764
297,297,288,1,1175
299,299,288,1,330
300,300,289,7,65,93,492,529,674,1350,1902
301,301,289,10,281,401,455,748,1231,1373,1506,1566,1875,1906
302,302,289,12,61,191,221,294,403,610,920,1307,1339,1477,1530,1703
303,303,289,40,20,23,60,98,182,184,234,258,345,493,531,543,648,700,750,821,919,1008,1015,1044,1059,1067,1080,1090,1091,1127,1181,1377,1388,1408,1419,1474,1508,1521,1625,1663,1675,1884,1956,1995
304,304,289,6,155,562,871,1018,1109,1684
305,305,289,7,261,314,669,1066,1142,1833,1937
306,306,289,7,82,202,430,467,734,1243,1648
307,307,289,7,293,385,474,581,818,1021,1636
