2,2,256,1,1642
3,3,256,1,923
4,4,256,2,1537,1693
5,5,256,2,569,936
7,7,256,1,233
10,10,257,1,902
13,13,257,1,549
15,15,257,1,480
16,16,258,2,62,248
18,18,258,1,409
20,20,258,1,1314
21,21,258,1,1262
22,22,258,1,1191
32,32,260,14,138,637,709,840,1161,1173,1306,1473,1488,1613,1743,1791,1801,1975
33,33,260,3,410,1267,1740
34,34,260,8,36,192,368,579,1246,1475,1534,1898
35,35,260,10,79,148,262,359,570,1108,1381,1673,1689,1998
36,36,260,11,278,518,1010,1033,1093,1163,1168,1431,1819,1858,1977
37,37,260,14,22,342,448,618,886,889,940,946,1036,1311,1526,1572,1924,1939
38,38,260,15,14,145,502,941,974,1051,1188,1190,1299,1584,1622,1698,1759,1789,1829
39,39,260,8,0,119,905,1017,1284,1355,1384,1914
41,41,261,2,1319,1457
42,42,261,1,1286
45,45,261,2,1290,1825
50,50,262,1,583
56,56,263,2,797,1771
57,57,263,2,4,469
58,58,263,3,513,731,1877
59,59,263,1,1841
60,60,263,2,28,985
61,61,263,5,507,1468,1503,1589,1635
62,62,263,2,568,1701
63,63,263,4,130,146,606,1803
72,72,265,1,621
74,74,265,1,1592
75,75,265,1,1599
77,77,265,1,845
79,79,265,1,578
92,92,267,1,1938
107,107,269,1,1600
122,122,271,1,1666
124,124,271,1,717
125,125,271,1,1522
137,137,273,1,958
187,187,279,1,1482
191,191,279,1,666
216,216,283,5,16,75,445,730,1053
217,217,283,5,250,484,1392,1499,1962
218,218,283,3,617,1291,1632
219,219,283,3,1321,1356,1446
220,220,283,3,534,580,1288
221,221,283,2,1496,1629
222,222,283,2,1,1400
223,223,283,1,1752
229,229,284,1,1674
237,237,285,1,511
240,240,286,1,859
256,256,288,7,233,569,923,936,1537,1642,1693
256,256,1,1,1858
256,256,5,1,1743
257,257,288,3,480,549,902
257,257,14,1,1431
258,258,288,5,62,248,409,1191,1262
258,258,289,1,1314
258,258,18,2,278,368
258,258,19,1,1898
258,258,21,1,905
258,258,22,1,1036
260,260,288,76,0,14,22,36,79,119,145,148,192,262,278,342,359,368,410,448,502,518,570,579,618,709,840,886,889,905,940,941,974,1010,1017,1033,1036,1051,1093,1108,1163,1168,1173,1188,1190,1246,1267,1284,1299,1306,1311,1355,1381,1384,1431,1473,1475,1488,1526,1534,1572,1584,1613,1622,1673,1689,1698,1740,1759,1789,1791,1819,1829,1858,1898,1914,1924,1939,1975,1998
260,260,289,7,138,637,946,1161,1743,1801,1977
261,261,288,5,1286,1290,1319,1457,1825
262,262,288,1,583
262,262,48,1,941
262,262,51,1,1188
263,263,288,15,4,28,130,146,469,513,568,606,731,797,985,1468,1771,1803,1841
263,263,289,6,507,1503,1589,1635,1701,1877
263,263,56,1,1819
263,263,57,1,1829
264,264,65,1,1572
264,264,69,1,359
265,265,288,5,578,621,845,1592,1599
265,265,78,1,342
267,267,288,1,1938
269,269,288,1,1600
271,271,288,3,717,1522,1666
271,271,120,1,1108
271,271,123,1,940
271,271,125,2,1384,1924
271,271,126,2,1017,1475
273,273,290,1,958
274,274,145,3,1381,1613,1841
274,274,147,1,1914
274,274,148,1,1010
274,274,150,1,1600
274,274,151,1,1488
275,275,152,2,1286,1977
275,275,154,2,569,583
275,275,155,1,145
275,275,156,1,974
275,275,157,1,1537
275,275,158,2,936,1262
275,275,159,2,1284,1998
276,276,164,1,1319
276,276,166,2,621,1191
277,277,169,1,192
277,277,171,1,1163
277,277,174,1,889
277,277,175,1,637
278,278,179,1,1689
278,278,181,2,119,1825
278,278,183,2,1673,1759
279,279,290,2,666,1482
279,279,184,2,1526,1622
279,279,185,2,709,1161
279,279,187,1,570
279,279,188,3,502,1306,1791
279,279,190,7,79,579,1190,1534,1584,1693,1698
279,279,191,3,840,946,1051
280,280,192,2,1311,1801
280,280,193,2,469,1168
280,280,197,1,148
280,280,198,1,1740
280,280,199,2,1267,1299
282,282,209,1,138
282,282,210,1,923
282,282,214,1,248
283,283,290,20,1,16,75,250,484,580,617,730,1053,1288,1321,1356,1392,1400,1446,1496,1499,1632,1752,1962
283,283,291,4,445,534,1291,1629
283,283,218,1,480
283,283,221,1,578
283,283,222,1,1642
284,284,290,1,1674
284,284,224,1,262
284,284,227,1,886
284,284,229,1,1938
284,284,230,1,902
285,285,290,1,511
285,285,233,2,410,549
285,285,234,1,1093
285,285,236,1,14
285,285,237,1,1355
285,285,238,3,1473,1789,1939
285,285,239,1,518
286,286,290,1,859
286,286,240,2,1033,1246
286,286,241,1,1457
286,286,243,1,409
286,286,244,1,448
286,286,245,1,0
286,286,246,1,22
287,287,248,12,28,75,233,730,797,845,958,1392,1499,1522,1592,1701
287,287,249,6,1,445,511,580,859,1752
287,287,250,11,36,507,534,717,1173,1290,1291,1314,1589,1599,1975
287,287,251,5,146,484,1321,1446,1629
287,287,252,13,130,250,606,617,618,666,731,1400,1482,1632,1635,1674,1962
287,287,253,3,62,985,1803
287,287,254,6,4,16,513,1356,1496,1503
287,287,255,7,568,1053,1288,1468,1666,1771,1877
288,288,292,40,22,148,248,469,480,549,569,578,583,618,621,709,886,902,923,936,1010,1093,1163,1173,1191,1262,1284,1286,1319,1355,1457,1468,1522,1537,1599,1600,1642,1693,1698,1825,1841,1938,1975,1998
288,288,293,3,192,1473,1771
288,288,294,9,62,79,409,985,1190,1246,1290,1803,1914
288,288,295,15,0,36,119,262,410,448,845,1033,1051,1267,1306,1488,1526,1584,1939
288,288,296,6,14,28,513,731,797,1789
288,288,297,8,146,502,579,889,974,1311,1666,1673
288,288,298,5,145,233,518,1689,1759
288,288,299,16,4,130,568,570,606,717,840,1168,1299,1381,1534,1592,1613,1622,1740,1791
288,288,256,1,1858
288,288,257,1,1431
288,288,258,5,278,368,905,1036,1898
288,288,262,2,941,1188
288,288,263,2,1819,1829
288,288,264,2,359,1572
288,288,265,1,342
288,288,271,6,940,1017,1108,1384,1475,1924
289,289,300,3,637,1701,1977
289,289,301,2,946,1635
289,289,302,2,507,1801
289,289,303,2,138,1877
289,289,305,1,1161
289,289,306,3,1314,1503,1589
289,289,256,1,1743
290,290,274,7,1010,1381,1488,1600,1613,1841,1914
290,290,275,10,145,569,583,936,974,1262,1284,1286,1537,1998
290,290,276,3,621,1191,1319
290,290,277,3,192,889,1163
290,290,278,5,119,1673,1689,1759,1825
290,290,279,16,79,502,570,579,709,840,1051,1190,1306,1526,1534,1584,1622,1693,1698,1791
290,290,280,7,148,469,1168,1267,1299,1311,1740
290,290,282,2,248,923
290,290,283,3,480,578,1642
290,290,284,4,262,886,902,1938
290,290,285,9,14,410,518,549,1093,1355,1473,1789,1939
290,290,286,7,0,22,409,448,1033,1246,1457
290,290,287,52,1,4,16,28,36,62,75,130,146,233,250,484,511,513,568,580,606,617,618,666,717,730,731,797,845,859,958,985,1053,1173,1288,1290,1321,1356,1392,1400,1446,1468,1482,1496,1499,1522,1592,1599,1632,1666,1674,1752,1771,1803,1962,1975
291,291,275,1,1977
291,291,277,1,637
291,291,279,2,946,1161
291,291,280,1,1801
291,291,282,1,138
291,291,287,11,445,507,534,1291,1314,1503,1589,1629,1635,1701,1877
292,292,290,40,22,148,248,469,480,549,569,578,583,618,621,709,886,902,923,936,1010,1093,1163,1173,1191,1262,1284,1286,1319,1355,1457,1468,1522,1537,1599,1600,1642,1693,1698,1825,1841,1938,1975,1998
293,293,290,3,192,1473,1771
294,294,290,9,62,79,409,985,1190,1246,1290,1803,1914
295,295,290,15,0,36,119,262,410,448,845,1033,1051,1267,1306,1488,1526,1584,1939
296,296,290,6,14,28,513,731,797,1789
297,297,290,8,146,502,579,889,974,1311,1666,1673
298,298,290,5,145,233,518,1689,1759
299,299,290,16,4,130,568,570,606,717,840,1168,1299,1381,1534,1592,1613,1622,1740,1791
300,300,291,3,637,1701,1977
301,301,291,2,946,1635
302,302,291,2,507,1801
303,303,291,2,138,1877
305,305,291,1,1161
306,306,291,3,1314,1503,1589
