8,8,257,1,1150
12,12,257,1,1415
15,15,257,1,645
37,37,260,3,121,393,872
38,38,260,1,1829
39,39,260,2,1069,1430
137,137,273,1,1971
139,139,273,1,1149
144,144,274,1,287
149,149,274,1,951
151,151,274,2,734,1231
152,152,275,2,65,1127
156,156,275,1,495
160,160,276,1,997
161,161,276,1,562
162,162,276,1,1535
166,166,276,1,796
167,167,276,2,206,474
169,169,277,1,967
171,171,277,2,305,1308
172,172,277,1,1318
174,174,277,1,1580
178,178,278,1,524
183,183,278,1,1564
184,184,279,3,61,1437,1575
185,185,279,1,1604
187,187,279,3,401,1091,1243
188,188,279,2,1350,1833
189,189,279,1,1970
192,192,280,1,871
193,193,280,1,674
194,194,280,1,1370
195,195,280,1,1978
197,197,280,3,403,458,1636
198,198,280,1,1519
199,199,280,1,669
209,209,282,1,5
211,211,282,1,1506
216,216,283,1,50
225,225,284,1,1892
230,230,284,1,636
234,234,285,1,54
235,235,285,1,1160
237,237,285,3,281,430,529
242,242,286,1,581
248,248,287,7,241,455,586,920,998,1354,1869
249,249,287,8,648,818,992,1018,1162,1675,1704,1937
250,250,287,15,93,261,330,473,746,750,821,1021,1109,1142,1307,1336,1566,1821,1906
251,251,287,4,1005,1008,1648,1972
252,252,287,10,191,318,373,622,748,1026,1345,1477,1628,1902
253,253,287,18,82,204,265,282,322,385,561,1066,1209,1269,1278,1339,1530,1533,1581,1749,1875,1958
254,254,287,10,202,221,294,467,492,505,610,772,1057,1657
255,255,287,10,155,293,314,531,608,960,1373,1555,1684,1703
256,256,0,2,951,1648
256,256,2,1,1278
256,256,3,1,1318
257,257,289,3,645,1150,1415
257,257,9,1,458
257,257,10,1,1437
257,257,13,1,1149
257,257,14,1,1308
258,258,18,2,1370,1970
258,258,19,2,796,1892
260,260,288,1,1829
260,260,289,5,121,393,872,1069,1430
260,260,32,2,293,305
260,260,33,3,636,997,1535
260,260,34,2,1566,1575
260,260,35,1,610
260,260,39,1,967
261,261,41,2,1373,1906
261,261,45,1,467
261,261,46,1,1021
261,261,47,2,5,1008
262,262,49,2,206,287
262,262,50,1,1564
262,262,53,1,1971
263,263,56,10,65,529,669,748,750,821,871,920,1066,1307
263,263,57,13,155,261,330,992,998,1109,1127,1160,1339,1530,1684,1829,1833
263,263,58,8,82,93,121,581,1018,1150,1231,1875
263,263,59,10,61,401,403,430,648,734,818,1142,1269,1506
263,263,60,10,221,294,385,562,674,872,1209,1581,1703,1902
263,263,61,5,202,393,645,1415,1533
263,263,62,8,281,314,455,474,1069,1430,1636,1937
263,263,63,5,191,322,1091,1243,1350
264,264,66,1,1675
264,264,67,1,54
264,264,69,1,1978
264,264,70,1,531
264,264,71,1,1477
265,265,72,2,495,524
265,265,78,1,50
271,271,120,1,1580
271,271,121,1,1604
271,271,124,1,1958
271,271,125,1,1519
271,271,126,1,492
273,273,291,2,1149,1971
274,274,291,4,287,734,951,1231
274,274,147,1,1704
275,275,291,3,65,495,1127
276,276,291,6,206,474,562,796,997,1535
276,276,166,1,1869
277,277,291,5,305,967,1308,1318,1580
278,278,291,2,524,1564
279,279,291,10,61,401,1091,1243,1350,1437,1575,1604,1833,1970
279,279,185,1,1657
279,279,186,1,1336
280,280,291,9,403,458,669,674,871,1370,1519,1636,1978
280,280,197,1,241
282,282,291,2,5,1506
283,283,291,1,50
283,283,216,3,204,1005,1354
283,283,217,4,608,1057,1162,1749
283,283,218,3,473,772,1026
283,283,219,2,265,1972
283,283,220,1,586
283,283,221,4,373,746,1345,1555
283,283,222,2,622,1628
283,283,223,4,282,505,960,1821
284,284,291,2,636,1892
284,284,225,1,561
284,284,226,1,318
285,285,290,1,1160
285,285,291,4,54,281,430,529
286,286,291,1,581
287,287,290,15,204,282,322,330,561,920,992,998,1142,1209,1269,1278,1533,1581,1958
287,287,291,67,82,93,155,191,202,221,241,261,265,293,294,314,318,373,385,455,467,473,492,505,531,586,608,610,622,648,746,748,750,772,818,821,960,1005,1008,1018,1021,1026,1057,1066,1109,1162,1307,1336,1339,1345,1354,1373,1477,1530,1555,1566,1628,1648,1657,1675,1684,1703,1704,1749,1821,1869,1875,1902,1906,1937,1972
288,288,256,1,1278
288,288,263,12,322,330,920,992,998,1142,1160,1209,1269,1533,1581,1829
288,288,271,1,1958
289,289,256,3,951,1318,1648
289,289,257,4,458,1149,1308,1437
289,289,258,4,796,1370,1892,1970
289,289,260,9,293,305,610,636,967,997,1535,1566,1575
289,289,261,6,5,467,1008,1021,1373,1906
289,289,262,4,206,287,1564,1971
289,289,263,57,61,65,82,93,121,155,191,202,221,261,281,294,314,385,393,401,403,430,455,474,529,562,581,645,648,669,674,734,748,750,818,821,871,872,1018,1066,1069,1091,1109,1127,1150,1231,1243,1307,1339,1350,1415,1430,1506,1530,1636,1684,1703,1833,1875,1902,1937
289,289,264,5,54,531,1477,1675,1978
289,289,265,3,50,495,524
289,289,271,4,492,1519,1580,1604
290,290,292,1,322
290,290,293,2,920,998
290,290,294,2,1142,1209
290,290,295,3,1278,1581,1958
290,290,296,1,1160
290,290,297,1,992
290,290,298,1,1269
290,290,299,2,330,1533
290,290,283,2,204,282
290,290,284,1,561
291,291,300,7,65,93,492,529,674,1350,1902
291,291,301,10,281,401,455,748,1231,1373,1506,1566,1875,1906
291,291,302,40,5,50,54,61,191,206,221,287,294,305,403,458,495,524,610,636,796,951,967,997,1149,1307,1308,1318,1339,1370,1437,1477,1519,1530,1535,1564,1575,1580,1604,1703,1892,1970,1971,1978
291,291,303,8,531,648,750,821,1008,1091,1127,1675
291,291,304,6,155,562,871,1018,1109,1684
291,291,305,6,261,314,669,1066,1833,1937
291,291,306,7,82,202,430,467,734,1243,1648
291,291,307,7,293,385,474,581,818,1021,1636
291,291,274,1,1704
291,291,276,1,1869
291,291,279,2,1336,1657
291,291,280,1,241
291,291,283,21,265,373,473,505,586,608,622,746,772,960,1005,1026,1057,1162,1345,1354,1555,1628,1749,1821,1972
291,291,284,1,318
292,292,288,1,322
293,293,288,2,920,998
294,294,288,2,1142,1209
295,295,288,3,1278,1581,1958
296,296,288,1,1160
297,297,288,1,992
298,298,288,1,1269
299,299,288,2,330,1533
300,300,289,7,65,93,492,529,674,1350,1902
301,301,289,10,281,401,455,748,1231,1373,1506,1566,1875,1906
302,302,289,40,5,50,54,61,191,206,221,287,294,305,403,458,495,524,610,636,796,951,967,997,1149,1307,1308,1318,1339,1370,1437,1477,1519,1530,1535,1564,1575,1580,1604,1703,1892,1970,1971,1978
303,303,289,8,531,648,750,821,1008,1091,1127,1675
304,304,289,6,155,562,871,1018,1109,1684
305,305,289,6,261,314,669,1066,1833,1937
306,306,289,7,82,202,430,467,734,1243,1648
307,307,289,7,293,385,474,581,818,1021,1636
